11111111111111111111111111111111111111111111111111111
10000C0000000000000000000000000000000000C000000000001
11111111111111111111111111111111111111111111111111101
10000000000000000000000000000000000000C00000000000101
1011111111111111111111111111111111111111111111111C1C1
10100000000000000000000000000000000000000000000000101
10111111111111111111111111111111111111111111111111101
101000000000000000000000000000000000000000000000001C1
10111111111111111111111111111111111111111111111110101
100000000000000000000000000000000000000000000E0000101
11111111111111111111111111111111111111111111111111101
1000000000000C00000000000000000000000000000P0000000C1
11111111111111111111111111111111111111111111111111111
