1111111111111
1000000000101
1000c0p000011
1111111111111