1111111111111
1000000000101
1000C0P000011
1111111111111